#########B##
#          #
#    #######
#    #    ##
# #### #####
#       #  #
###### ## ##
#A         #